1111111111
1FC00000F1
10000FE001
1P0C000001
1111111111