1111111111
10C0000001
1F00C0E001
1P00000001
1111111111