1111111111
1FC0000001
100000E001
1P0C000001
1111111111