1111111111
10C0000001
1000C0E001
1P0FF0F001
1111111111