1111111111
10C00000F1
1F0F00E0F1
1P0C000001
1111111111