1111111111
10C0000001
1F0F00E001
1P0C000001
1111111111